10,,,,,,,,,
5,5,5,5,5,5,5,5,5,5
5,5,5,5,5,5,5,5,5,5
5,5,4,4,4,4,4,4,4,4
5,5,4,3,3,3,3,3,3,3
5,5,4,3,2,2,2,2,2,2
5,5,4,3,2,1,1,1,1,1
5,5,4,3,2,1,0,0,0,0
5,5,4,3,2,1,0,0,0,0
5,5,4,3,2,1,0,0,0,0
5,5,4,3,2,1,0,0,0,0
